-------------------------
-------------------------
-------------------------
-------------------------
-------------------------
-------------------------
-------------------------
-------------------------
-------------------------
-------------------------
-------------------------
-------------------------
-------------------------
-------------------------
@------------------------
-------------------------
b-----e------------------
b------------------------
b^^^^^^^^^^^^^^^^^^^^^^^^